11111111111111
10010000000C11
1E000111110011
1P0011E0000N11
11111111111111
