11111111111111
100100C0000C01
1E000111110001
1P00C10CCCCN01
11111111111111
