111111
10PCE1
100001
110001
100001
111111
