


111111
10PCE1
100001
1100N1
100001
100001
100001
111111
